# ##############################.#
#      # .. #### ! #! #   #......#
#### g . .     #   #      #..#####
# .... ##### ....  ####   #....  #
#m ## ## .  . #     # g ..####..##
#... g .  # . #  ...   ..    ..  #
####!#### # . # #   #   ### #..# #
#   g   . ## .  #  ##      m ..  #
# .  .  !  ..   #g      #### ..  #
# . ..    .  .. ### # .. ..## .  #
#   ...  .  ..        . # . ##.. #
#  ..      ..  !  #     # .. . . #
#...  p....  .   #    ..##########